antilopa|антилопа|
anakonda|анаконда|A
avet|авет|A
afričkislon|africkislon|афричкислон|A
ajvi|ајви|A
albatros|албатрос|A
ajkula|ајкула|A
aligator|алигатор|A
ajkulakit|ајкулакит|A
ajkulačekićara|ajkulacekicara|ајкулачекићара|A
amur|амур|A
armadilo|армадило|A
aj-aj||A
ajaj|ајај|A
at|ат|A
ara|ара|A
babun|бабун|B
belinosorog|белиносорог|B
bengalskitigar|бенгалскитигар|B
bufalo|буфало|B
bradavičastasvinja|bradavicastasvinja|брадавичастасвиња|A
barakuda|баракуда|B
balonastariba|балонастариба|B
brancin|бранцин|B
bivol|бивол|B
bazilisk|базилиск|B
barbusriba|барбусриба|B
bumbar|бумбар|B
bubamara|бубамара|B
bluna|блуна|B
beloglavisup|белоглависуп|B
barskakornjača|barskakornjaca|барскакорњача|B
bizon|бизон|B
bik|бик|B
bumsleng|бумсленг|B
bodljikavoprase|бодљикавопрасе|B
bonobo|бонобо|B
belimedved|белимедвед|B
bogomoljka|богомољка|B
bubašvaba|bubasvaba|бубашваба|B
biljnavaš|biljnavas|биљнаваш|B
blavor|блавор|B
belouška|belouska|белоушка|B
balegar|балегар|B
bakalar|бакалар|B
boa|боа|B
bivo|биво|B
bandar|бандар|B
vidra|видра|V
veverica|веверица|V
vuk|вук|V
veveričastimajmun|vevericastimajmun|веверичастимајмун|B
vrana|врана|V
vilinkonjic|вилинкоњиц|V
vivak|вивак|V
vetruška|vetruska|ветрушка|V
vrabac|врабац|V
varan|варан|V
vepar|вепар|V
vo|во|V
gazela|газела|G
galago|галаго|G
geko|геко|G
gepard|гепард|G
gebril|гебрил|G
gibon|гибон|G
gnu|гну|G
gorila|горила|G
grivastivuk|гривастивук|G
grizli|гризли|G
guanako|гуанако|G
golub|голуб|G
guska|гуска|G
gušter|guster|гуштер|V
govedo|говедо|G
galeb|галеб|G
gavran|гавран|G
galapagoskornjača|galapagoskornjaca|галапагоскорњача|G
gabonskaljutica|габонскаљутица|G
gabonskazmija|габонсказмија|G
gugutka|гугутка|G
grlica|грлица|G
gak|гак|G
grgeč|grgec|гргеч|G
gusenica|гусеница|G
glista|глиста|G
delfin|делфин|D
dabar|дабар|D
dvogrbakamila|двогрбакамила|D
dingo|динго|D
divljikonj|дивљикоњ|D
divokoza|дивокоза|D
domaćasvinja|domacasvinja|домаћасвиња|G
dril|дрил|D
detlić|detlic|детлић|D
divljasvinja|дивљасвиња|D
daždevnjak|dazdevnjak|даждевњак|D
diskus|дискус|D
divljivepar|дивљивепар|D
deverika|деверика|D
dagnja|дагња|D
emu|ему|E
električnajegulja|elektricnajegulja|електричнајегуља|D
žirafa|zirafa|жирафа|Ž
žaba|zaba|жаба|Ž
ždral|zdral|ждрал|Ž
žuna|zuna|жуна|Ž
ždrebe|zdrebe|ждребе|Ž
zmija|змија|E
zebra|зебра|Z
zec|зец|Z
zlatnitamarin|златнитамарин|Z
zubatac|зубатац|Z
zebu|зебу|Z
zvečarka|zvecarka|звечарка|Z
zrikavac|зрикавац|Z
indijskislon|индијскислон|I
impala|импала|I
irvas|ирвас|I
iguana|игуана|I
ibis|ибис|I
inćun|incun|инћун|Z
iverak|иверак|I
jež|jez|јеж|I
jaguar|јагуар|J
jaguarundi|јагуарунди|J
jak|јак|J
jednogrbakamila|једногрбакамила|J
jastreb|јастреб|J
jegulja|јегуља|J
jazavac|јазавац|J
jastog|јастог|J
jelen|јелен|J
jarebica|јаребица|J
jarac|јарац|J
jelenak|јеленак|J
jesetra|јесетра|J
jare|јаре|J
jagnje|јагње|J
kapibara|капибара|K
karakal|каракал|K
kengur|кенгур|K
kinkajou|кинкајоу|K
kitubica|китубица|K
kljunar|кљунар|K
koala|коала|K
krava|крава|K
koza|коза|K
kit|кит|K
kakadu|какаду|K
kokoška|kokoska|кокошка|J
kardinal|кардинал|K
kivi|киви|K
kolibri|колибри|K
kraljevskipingvin|краљевскипингвин|K
konj|коњ|K
kraba|краба|K
krokodil|крокодил|K
kamila|камила|K
kanarinac|канаринац|K
kunić|kunic|кунић|K
komarac|комарац|K
kornjača|kornjaca|корњача|K
kameleon|камелеон|K
kraljevskakobra|краљевскакобра|K
kobra|кобра|K
ksenosaur|ксеносаур|K
kukuruznazmija|кукурузназмија|K
kajman|кајман|K
kormoran|корморан|K
kukavica|кукавица|K
kobac|кобац|K
kukuvija|кукувија|K
kos|кос|K
komodskivaran|комодскиваран|K
komodskizmaj|комодскизмај|K
kunabelica|кунабелица|K
kunazlatica|куназлатица|K
krtica|кртица|K
kazuar|казуар|K
kotrljan|котрљан|K
krompirovazlatica|кромпировазлатица|K
kečiga|keciga|кечига|K
karaš|karas|караш|K
klen|клен|K
kobila|кобила|K
ker|кер|K
kuče|kuce|куче|K
krpelj|крпељ|K
krmača|krmaca|крмача|K
kišnaglista|kisnaglista|кишнаглиста|K
lama|лама|K
lav|лав|L
lemur|лемур|L
lenjivac|лењивац|L
leopard|леопард|L
los|лос|L
lisica|лисица|L
labud|лабуд|L
lešinar|lesinar|лешинар|L
lasica|ласица|L
leptir|лептир|L
lasta|ласта|L
lipljen|липљен|L
lignja|лигња|L
losos|лосос|L
ljuskar|љускар|LJ
ljiljak|љиљак|LJ
ljiljci|љиљци|LJ
maca|маца|M
mačka|macka|мачка|L
mačak|macak|мачак|M
mačor|macor|мачор|M
morž|morz|морж|M
madagaskarskitenrek|мадагаскарскитенрек|M
madagaskarskiprstaš|madagaskarskiprstas|мадагаскарскипрсташ|M
magarac|магарац|M
magare|магаре|M
mazga|мазга|M
mula|мула|M
medved|медвед|M
marmozet|мармозет|M
mandril|мандрил|M
margaj|маргај|M
miš|mis|миш|M
morskavidra|морскавидра|M
mravojed|мравојед|M
mungos|мунгос|M
majmun|мајмун|M
makau|макау|M
morskipas|морскипас|M
muva|мува|M
mušica|musica|мушица|M
mrav|мрав|M
mlečnazmija|mlecnazmija|млечназмија|M
morskakornjača|morskakornjaca|морскакорњача|M
morskikonj|морскикоњ|M
morskipauk|морскипаук|M
morskazvezda|морсказвезда|M
meduza|медуза|M
merkat|меркат|M
mrmot|мрмот|M
moruna|моруна|M
mrena|мрена|M
manić|manic|манић|M
moljac|мољац|M
morka|морка|M
muflon|муфлон|M
nilskikonj|нилскикоњ|N
noj|ној|N
nosorog|носорог|N
nilskikrokodil|нилскикрокодил|N
nosorogbuba|носорогбуба|N
narval|нарвал|N
nandu|нанду|N
njorka|њорка|NJ
ocelot|оцелот|O
okapi|окапи|O
ončila|oncila|ончила|M
oposum|опосум|O
orangutan|орангутан|O
ovca|овца|O
orao|орао|O
oskarriba|оскарриба|O
oskar|оскар|O
orada|орада|O
oktopod|октопод|O
ovan|ован|O
osa|оса|O
orka|орка|O
orkakitubica|оркакитубица|O
oslić|oslic|ослић|O
obad|обад|O
panda|панда|P
pacov|пацов|P
ptica|птица|P
patuljastimungos|патуљастимунгос|P
peščanamačka|pescanamacka|пешчанамачка|O
plavikit|плавикит|P
polarnimedved|поларнимедвед|P
puma|пума|P
pustinjskalisica|пустињскалисица|P
pustinjskivuk|пустињскивук|P
pingvin|пингвин|P
papagaj|папагај|P
pelikan|пеликан|P
paun|паун|P
pticatrkačica|pticatrkacica|птицатркачица|P
pirana|пирана|P
paku|паку|P
plavaajkula|плаваајкула|P
patka|патка|P
pas|пас|P
prepelica|препелица|P
pčela|pcela|пчела|P
piton|питон|P
patuljastikajman|патуљастикајман|P
pustinjskakornjača|pustinjskakornjaca|пустињскакорњача|P
plovka|пловка|P
pomrakuša|pomrakusa|помракуша|P
petao|петао|P
pile|пиле|P
pangolin|панголин|P
pavijan|павијан|P
popac|попац|P
poskok|поскок|P
pauk|паук|P
pastrmka|пастрмка|P
papalina|папалина|P
puž|puz|пуж|P
planarija|планарија|P
prase|прасе|P
prstac|прстац|P
panter|пантер|P
rakun|ракун|R
ris|рис|R
rajskaptica|рајскаптица|R
roda|рода|R
rovac|ровац|R
rak|рак|R
raža|raza|ража|P
riba|риба|R
slon|слон|S
sibirskitigar|сибирскитигар|S
sivikit|сивикит|S
snežnileopard|sneznileopard|снежнилеопард|R
slepimiš|slepimis|слепимиш|S
snežnasova|sneznasova|снежнасова|S
soko|соко|S
sova|сова|S
sabljarka|сабљарка|S
skuša|skusa|скуша|S
svinja|свиња|S
srna|срна|S
skakavac|скакавац|S
svitac|свитац|S
sipa|сипа|S
sprudnik|спрудник|S
slavuj|славуј|S
suriorao|суриорао|S
svraka|сврака|S
sojka|сојка|S
senica|сеница|S
salamander|саламандер|S
slepić|slepic|слепић|S
stenica|стеница|S
smrdibuba|смрдибуба|S
smuk|смук|S
som|сом|S
stršljen|strsljen|стршљен|S
smuđ|smudj|смуђ|S
sardela|сардела|S
srndać|srndac|срндаћ|S
smeđabubašvaba|smedjabubasvaba|смеђабубашваба|S
sunđer|sundjer|сунђер|S
tapir|тапир|S
tasmanijskiđavo|tasmanijskidjavo|тасманијскиђаво|T
tarzer|тарзер|T
tvor|твор|T
tetreb|тетреб|T
trogon|трогон|T
tetra|тетра|T
tambakjui|тамбакјуи|T
tigar|тигар|T
tarantula|тарантула|T
termit|термит|T
tinamu|тинаму|T
tukan|тукан|T
tajpan|тајпан|T
tolstolobik|толстолобик|T
tuna|туна|T
tajmen|тајмен|T
tele|теле|T
ćurka|curka|ћурка|T
ćuran|curan|ћуран|Ć
ćuk|cuk|ћук|Ć
udav|удав|Ć
ugor|угор|U
ulješura|uljesura|уљешура|U
foka|фока|U
flamingo|фламинго|F
fazan|фазан|F
fregata|фрегата|F
fosa|фоса|F
hijena|хијена|H
hobotnica|хоботница|H
hrčak|hrcak|хрчак|F
haringa|харинга|H
hidra|хидра|H
crninosorog|црниносорог|C
crvenapanda|црвенапанда|C
crv|црв|C
carić|caric|царић|H
crnamamba|црнамамба|C
cvrčak|cvrcak|цврчак|C
cipal|ципал|C
činčila|cincila|чинчила|C
čvorak|cvorak|чворак|Č
čavka|cavka|чавка|Č
čaplja|caplja|чапља|Č
čiopa|ciopa|чиопа|Č
češljugar|cesljugar|чешљугар|Č
čovečjaribica|covecjaribica|човечјарибица|Č
džukela|dzukela|џукела|DŽ
dživdžan|dzivdzan|џивџан|DŽ
džudžan|dzudzan|џуџан|DŽ
šakal|sakal|шакал|Š
šimpanza|simpanza|шимпанза|Š
šaran|saran|шаран|Š
štuka|stuka|штука|Š
škorpion|skorpion|шкорпион|Š
šljuka|sljuka|шљука|Š
štiglic|stiglic|штиглиц|Š
ševa|seva|шева|Š
šišmiš|sismis|шишмиш|Š
škorpija|skorpija|шкорпија|Š
šarka|sarka|шарка|Š
šargan|sargan|шарган|Š
šilac|silac|шилац|Š
škarpina|skarpina|шкарпина|Š
