artičoka|articoka|артичока|A
avokado|авокадо|
ananas|ананас|A
aronija|аронија|A
agava|агава|A
argan|арган|A
aloevera|алоевера|A
alojavera|алојавера|A
alojevera|алојевера|A
alpskaruža|alpskaruza|алпскаружа|A
anđelika|andjelika|анђелика|A
anis|анис|A
ariš|aris|ариш|A
arnika|арника|A
aronia|арониа|A
afelandra|афеландра|A
aspidistra|аспидистра|A
asparagus|аспарагус|A
amarilis|амарилис|A
anemona|анемона|A
anturijum|антуријум|A
anturium|антуриум|A
ahimenes|ахименес|A
adam|адам|A
ajahuaska|ајахуаска|A
abonos|абонос|A
beliluk|белилук|B
blitva|блитва|B
boranija|боранија|B
bob|боб|B
brokoli|броколи|B
bundeva|бундева|B
badem|бадем|B
banana|банана|B
breskva|бресква|B
borovnica|боровница|B
brusnica|брусница|B
bergamota|бергамота|B
bagrem|багрем|B
bedrenika|бедреника|B
betonika|бетоника|B
bokvica|боквица|B
bor|бор|B
borač|borac|борач|A
bosiljak|босиљак|B
breza|бреза|B
bršljan|brsljan|бршљан|B
belagorčica|belagorcica|белагорчица|B
belislez|белислез|B
boražina|borazina|боражина|B
božur|bozur|божур|B
bambus|бамбус|B
begonija|бегонија|B
bugenvilija|бугенвилија|B
belarada|беларада|B
bukva|буква|B
brest|брест|B
brekinja|брекиња|B
baobab|баобаб|B
belibor|белибор|B
biber|бибер|B
bostan|бостан|B
bulka|булка|B
višnja|visnja|вишња|B
vanila|ванила|V
valerijana|валеријана|V
vidac|видац|V
vilinosito|вилиносито|V
vinovaloza|виновалоза|V
volujskouho|волујскоухо|V
vranilovka|враниловка|V
vrba|врба|V
vrbovica|врбовица|V
vresak|вресак|V
vrkuta|вркута|V
vodenapalma|воденапалма|V
visibaba|висибаба|V
vlašac|vlasac|влашац|V
virak|вирак|V
grah|грах|G
grašak|grasak|грашак|V
glog|глог|G
grožđe|grozdje|грожђе|G
grejpfrut|грејпфрут|G
guava|гуава|G
gavez|гавез|G
ginkobiloba|гинкобилоба|G
ginseng|гинсенг|G
gotukola|готукола|G
gujinatrava|гујинатрава|G
gerber|гербер|G
gladiola|гладиола|G
grab|граб|G
guzmanija|гузманија|G
guzmania|гузманиа|G
ginko|гинко|G
gandža|gandza|ганџа|G
gunja|гуња|G
dinja|диња|D
datula|датула|D
drenjina|дрењина|D
dud|дуд|D
dunja|дуња|D
daninoć|daninoc|даниноћ|G
detelina|детелина|D
dinjica|дињица|D
divizma|дивизма|D
divljajabuka|дивљајабука|D
divljakruška|divljakruska|дивљакрушка|D
dobričica|dobricica|добричица|D
drača|draca|драча|D
drač|drac|драч|D
dragoljub|драгољуб|D
dren|дрен|D
dubčac|dubcac|дубчац|D
difenbahija|дифенбахија|D
dracena|драцена|D
dalija|далија|D
duglazija|дуглазија|D
divljikesten|дивљикестен|D
duvan|дуван|D
dgunja|дгуња|D
drvozivota|дрвозивота|D
dolardrvo|долардрво|D
drvonovca|дрвоновца|D
drenjak|дрењак|D
đumbir|djumbir|ђумбир|D
đurđevak|djurdjevak|ђурђевак|Đ
ehinacea|ехинацеа|Đ
eukaliptus|еукалиптус|E
estragon|естрагон|E
žalfija|zalfija|жалфија|E
žutabroćika|zutabrocika|жутаброћика|Ž
žutinocurak|zutinocurak|жутиноцурак|Ž
žara|zara|жара|Ž
žalosnavrba|zalosnavrba|жалоснаврба|Ž
žito|zito|жито|Ž
zelenasalata|зеленасалата|Ž
zelje|зеље|Z
zob|зоб|Z
zečjitrn|zecjitrn|зечјитрн|Z
zdravac|здравац|Z
zlatica|златица|Z
zova|зова|Z
zmajevac|змајевац|Z
zumbul|зумбул|Z
zamija|замија|Z
zevalica|зевалица|Z
zlatnica|златница|Z
zmajskovoće|zmajskovoce|змајсковоће|Z
iđirot|idjirot|иђирот|I
imela|имела|Z
ivatrava|иватрава|I
ivanjskocveće|ivanjskocvece|ивањскоцвеће|I
iris|ирис|I
ivančica|ivancica|иванчица|I
indijskiorah|индијскиорах|I
iberis|иберис|I
igličak|iglicak|игличак|I
iglica|иглица|I
iva|ива|I
jagoda|јагода|J
jabuka|јабука|J
jujuba|јујуба|J
ječam|jecam|јечам|I
jaglac|јаглац|J
jagorčevina|jagorcevina|јагорчевина|J
jagličak|jaglicak|јагличак|J
jasen|јасен|J
ježovina|jezovina|јежовина|J
jasmin|јасмин|J
juka|јука|J
jorgovan|јоргован|J
jablan|јаблан|J
jasika|јасика|J
javor|јавор|J
jela|јела|J
karfiol|карфиол|K
keleraba|келераба|K
kelj|кељ|K
krastavac|краставац|K
krompir|кромпир|K
kupus|купус|K
kajsija|кајсија|K
kruška|kruska|крушка|J
kupina|купина|K
kokos|кокос|K
kokosovorah|кокосоворах|K
kikiriki|кикирики|K
kivi|киви|K
kesten|кестен|K
kaki|каки|K
karambola|карамбола|K
kumkvat|кумкват|K
kukuruz|кукуруз|K
kadulja|кадуља|K
kamilica|камилица|K
kantarion|кантарион|K
kičica|kicica|кичица|K
kilavica|килавица|K
kim|ким|K
kleka|клека|K
kokotac|кокотац|K
komorač|komorac|коморач|K
konjogriz|коњогриз|K
konoplja|конопља|K
konopljika|конопљика|K
kopitnjak|копитњак|K
kopriva|коприва|K
korijander|коријандер|K
krasuljak|красуљак|K
kamelija|камелија|K
karanfil|каранфил|K
kukurek|кукурек|K
kaktus|кактус|K
kala|кала|K
kroton|кротон|K
kafa|кафа|K
kakao|какао|K
krokus|крокус|K
klematis|клематис|K
klivija|кливија|K
kurika|курика|K
kedar|кедар|K
krin|крин|K
kanabis|канабис|K
koka|кока|K
kivano|кивано|K
kolijander|колијандер|K
lubenica|лубеница|L
lešnik|lesnik|лешник|K
limeta|лимета|L
limun|лимун|L
leska|леска|L
lan|лан|L
lanilist|ланилист|L
lavanda|лаванда|L
lazarkinja|лазаркиња|L
lincura|линцура|L
lipa|липа|L
lišajevica|lisajevica|лишајевица|L
lokvanj|локвањ|L
lala|лала|L
lovor|ловор|L
ladolež|ladolez|ладолеж|L
lepakata|лепаката|L
luk|лук|L
leblebija|леблебија|L
lotos|лотос|L
lobelija|лобелија|L
lupinus|лупинус|L
lotus|лотус|L
ljubičica|ljubicica|љубичица|L
ljubica|љубица|LJ
ljutovnica|љутовница|LJ
ljutić|ljutic|љутић|LJ
ljutići|ljutici|љутићи|LJ
ljiljan|љиљан|LJ
ljulj|љуљ|LJ
mrkva|мрква|M
malina|малина|M
mandarina|мандарина|M
mango|манго|M
maslina|маслина|M
mušmula|musmula|мушмула|LJ
mak|мак|M
makadamija|макадамија|M
marakuja|маракуја|M
mačjinokat|macjinokat|мачјинокат|M
maćuhica|macuhica|маћухица|M
majčinadušica|majcinadusica|мајчинадушица|M
majoran|мајоран|M
maslačak|maslacak|маслачак|M
matičnjak|maticnjak|матичњак|M
metvica|метвица|M
miloduh|милодух|M
mirođija|mirodjija|мирођија|M
morač|morac|морач|M
murva|мурва|M
mesožderka|mesozderka|месождерка|M
magnolija|магнолија|M
mimoza|мимоза|M
muškatla|muskatla|мушкатла|M
mahonija|махонија|M
marihuana|марихуана|M
mahovina|маховина|M
nar|нар|N
narandža|narandza|наранџа|M
nektarina|нектарина|N
noni|нони|N
nana|нана|N
neven|невен|N
narcis|нарцис|N
naprstak|напрстак|N
ogrozd|огрозд|O
orah|орах|O
oskoruša|oskorusa|оскоруша|N
ovas|овас|O
očajnica|ocajnica|очајница|O
oman|оман|O
orhideja|орхидеја|O
oleander|олеандер|O
omorika|оморика|O
origano|оригано|O
paprika|паприка|P
paradajz|парадајз|P
pasulj|пасуљ|P
plavipatlidžan|plavipatlidzan|плавипатлиџан|O
paškanat|paskanat|пашканат|P
praziluk|празилук|P
prokelj|прокељ|P
peršun|persun|першун|P
pomorandža|pomorandza|поморанџа|P
papaja|папаја|P
pistać|pistac|пистаћ|P
pasionarka|пасионарка|P
pepino|пепино|P
pomelo|помело|P
pirinač|pirinac|пиринач|P
pšenica|psenica|пшеница|P
pamuk|памук|P
paprat|папрат|P
pelin|пелин|P
petoprstasteža|petoprstasteza|петопрстастежа|P
petrovac|петровац|P
pirevina|пиревина|P
piskavica|пискавица|P
plućnjak|plucnjak|плућњак|P
podbel|подбел|P
podubica|подубица|P
potočnjak|potocnjak|поточњак|P
preslica|преслица|P
prilip|прилип|P
prostrel|прострел|P
pasjitrn|пасјитрн|P
palma|палма|P
persijskaciklama|персијскациклама|P
pančićevaomorika|pancicevaomorika|панчићеваоморика|P
perunika|перуника|P
papirus|папирус|P
protea|протеа|P
plumerija|плумерија|P
petunija|петунија|P
pupavica|пупавица|P
pakujac|пакујац|P
petunia|петуниа|P
petlovakresta|петловакреста|P
prkos|пркос|P
patlidžan|patlidzan|патлиџан|P
pitaja|питаја|P
raštika|rastika|раштика|P
rotkvica|ротквица|R
rotkva|ротква|R
ren|рен|R
rukola|рукола|R
repa|репа|R
rogač|rogac|рогач|R
riža|riza|рижа|R
raž|raz|раж|R
ribizla|рибизла|R
rusa|руса|R
rosopas|росопас|R
rusomača|rusomaca|русомача|R
ruža|ruza|ружа|R
ruzmarin|рузмарин|R
rastavić|rastavic|раставић|R
ricinus|рицинус|R
runolist|рунолист|R
spanać|spanac|спанаћ|R
sočivo|socivo|сочиво|S
smokva|смоква|S
suncokret|сунцокрет|S
soja|соја|S
slačica|slacica|слачица|S
sremuš|sremus|сремуш|S
slez|слез|S
salep|салеп|S
selen|селен|S
sena|сена|S
sitnica|ситница|S
sladić|sladic|сладић|S
smilje|смиље|S
smreka|смрека|S
solomonovpečat|solomonovpecat|соломоновпечат|S
stolisnik|столисник|S
srčanik|srcanik|срчаник|S
sasa|саса|S
sanseverija|сансеверија|S
sansevieria|сансевиериа|S
spatifilum|спатифилум|S
spatifilijum|спатифилијум|S
salvija|салвија|S
stevija|стевија|S
stevia|стевиа|S
smrča|smrca|смрча|S
sekvoja|секвоја|S
susam|сусам|S
tikva|тиква|T
tikvica|тиквица|T
trešnja|tresnja|трешња|S
tratinčica|tratincica|тратинчица|T
tahebo|тахебо|T
timijan|тимијан|T
trbulja|трбуља|T
troskot|троскот|T
tilandsija|тиландсија|T
tulipan|тулипан|T
tuja|туја|T
trska|трска|T
trava|трава|T
tritoma|тритома|T
trnjina|трњина|T
topola|топола|T
tisa|тиса|T
tartuf|тартуф|T
tamjanika|тамјаника|T
travaiva|траваива|T
urma|урма|U
unabi|унаби|U
uva|ува|U
uljenarepica|уљенарепица|U
fizalis|физалис|F
fikus|фикус|F
filadendron|филадендрон|F
heljda|хељда|H
hajdučkatrava|hajduckatrava|хајдучкатрава|T
hibiskus|хибискус|H
hmelj|хмељ|H
hrast|храст|H
hortenzija|хортензија|H
helikonija|хеликонија|H
hrizantema|хризантема|H
cvekla|цвекла|C
celer|целер|C
crniluk|црнилук|C
crnaribizla|црнарибизла|C
cimet|цимет|C
cikorija|цикорија|C
crvotočina|crvotocina|црвоточина|H
crnislez|црнислез|C
ciperus|циперус|C
ciklama|циклама|C
cinija|цинија|C
crnibor|црнибор|C
cer|цер|C
crnaslačica|crnaslacica|црнаслачица|C
čičoka|cicoka|чичока|Č
čerimoja|cerimoja|черимоја|Č
čestoslavica|cestoslavica|честославица|Č
čičak|cicak|чичак|Č
čuvarkuća|cuvarkuca|чуваркућа|Č
čempres|cempres|чемпрес|Č
čubar|cubar|чубар|Č
dženarika|dzenarika|џенарика|DŽ
džanarika|dzanarika|џанарика|DŽ
šargarepa|sargarepa|шаргарепа|Š
špargla|spargla|шпаргла|Š
šljiva|sljiva|шљива|Š
šimšir|simsir|шимшир|Š
šipak|sipak|шипак|Š
šipurika|sipurika|шипурика|Š
štavelj|stavelj|штавељ|Š
šećernarepa|secernarepa|шећернарепа|Š
šeflera|seflera|шефлера|Š
šafran|safran|шафран|Š
šipurak|sipurak|шипурак|Š
