arnauta|арнаута|
amstel|амстел|A
amur|амур|A
amazon|амазон|A
apurimak|апуримак|A
angara|ангара|A
argun|аргун|A
aragvaja|арагваја|A
amudarja|амударја|A
arkanzas|арканзас|A
aldan|алдан|A
alegeni|алегени|A
ada|ада|A
adiđe|adidje|адиђе|A
arno|арно|A
ana|ана|A
begej|бегеј|B
bosut|босут|B
brzava|брзава|B
budovar|будовар|B
belidrim|белидрим|B
belitimok|белитимок|B
belica|белица|B
barbatovačkareka|barbatovackareka|барбатовачкарека|A
bitva|битва|B
banjskareka|бањскарека|B
borovštica|borovstica|боровштица|B
bolečica|bolecica|болечица|B
bjelica|бјелица|B
bosna|босна|B
bojana|бојана|B
breznica|брезница|B
bednja|бедња|B
bregalnica|брегалница|B
bramaputra|брамапутра|B
breg|брег|B
bisernareka|бисернарека|B
bistrica|бистрица|B
bug|буг|B
bjela|бјела|B
velikamorava|великаморава|V
veternica|ветерница|V
vlasina|власина|V
visočica|visocica|височица|B
vizelj|визељ|V
velikibegej|великибегеј|V
vrelo|врело|V
vrbas|врбас|V
vrbanja|врбања|V
vuka|вука|V
vardar|вардар|V
vezer|везер|V
vltava|влтава|V
volga|волга|V
viljuj|виљуј|V
visla|висла|V
vilija|вилија|V
volta|волта|V
vinci|винци|V
vinči|винчи|V
gruža|gruza|гружа|V
golijskamoravica|голијскаморавица|G
galovica|галовица|G
gradac|градац|G
guzajna|гузајна|G
gabrovačkareka|gabrovackareka|габровачкарека|G
golemareka|големарека|G
golema|голема|G
gvadijana|гвадијана|G
garona|гарона|G
gang|ганг|G
ganga|ганга|G
gornjiob|горњиоб|G
gvadalkivir|гвадалкивир|G
gediz|гедиз|G
glina|глина|G
gomjenica|гомјеница|G
dunav|дунав|D
drina|дрина|D
drim|дрим|D
dragovištica|dragovistica|драговиштица|G
dečanskabistrica|decanskabistrica|дечанскабистрица|D
drenica|дреница|D
dičina|dicina|дичина|D
dobrava|добрава|D
despotovica|деспотовица|D
drava|драва|D
duero|дуеро|D
don|дон|D
darling|дарлинг|D
donjatunguska|доњатунгуска|D
dnjepar|дњепар|D
dobra|добра|D
đetinja|djetinja|ђетиња|D
đehotina|djehotina|ђехотина|Đ
erenik|ереник|Đ
ems|емс|E
elde|елде|E
elba|елба|E
ebro|ебро|E
eufrat|еуфрат|E
esko|еско|E
žapura|zapura|жапура|E
žurua|zurua|журуа|Ž
žepa|zepa|жепа|Ž
željeznica|zeljeznica|жељезница|Ž
žutareka|жутарека|Ž
žuta|жута|Ž
zutareka|зутарека|Ž
zuta|зута|Ž
zlatica|златица|Z
zapadnamorava|западнаморава|Z
zasavica|засавица|Z
zlotskareka|злотскарека|Z
zeta|зета|Z
zair|заир|Z
zambezi|замбези|Z
zrmanja|зрмања|Z
ibar|ибар|I
irtiš|irtis|иртиш|Ž
ind|инд|I
išim|isim|ишим|I
iravadi|иравади|I
in|ин|I
ilova|илова|I
izar|изар|I
južnamorava|juznamorava|јужнаморава|I
jablanica|јабланица|J
jasenica|јасеница|J
jadar|јадар|J
jerma|јерма|J
jegrička|jegricka|јегричка|J
jerez|јерез|J
jaseničkareka|jasenickareka|јасеничкарека|J
jarčina|jarcina|јарчина|J
jezava|језава|J
jovanovačkareka|jovanovackareka|јовановачкарека|J
janja|јања|J
jenisej|јенисеј|J
jangcekjang|јангцекјанг|J
jangce|јангце|J
jukon|јукон|J
jordan|јордан|J
jalu|јалу|J
jelaškareka|jelaskareka|јелашкарека|J
jelaška|jelaska|јелашка|J
jala|јала|J
jošanica|josanica|јошаница|J
jurkovica|јурковица|J
janjina|јањина|J
kiđoš|kidjos|киђош|J
kolubara|колубара|K
karaš|karas|караш|K
krivaja|криваја|K
kereš|keres|кереш|K
klina|клина|K
kalenićkareka|kalenickareka|каленићкарека|K
kubršnica|kubrsnica|кубршница|K
kutinskareka|кутинскарека|K
kosanica|косаница|K
kudoš|kudos|кудош|K
kačer|kacer|качер|K
krnješevci|krnjesevci|крњешевци|K
keveriš|keveris|кевериш|K
kamenica|каменица|K
komarnica|комарница|K
kupa|купа|K
krka|крка|K
korana|корана|K
kagera|кагера|K
kongo|конго|K
kaketa|какета|K
kolima|колима|K
katun|катун|K
kolambija|коламбија|K
kolorado|колорадо|K
kazai|казаи|K
lim|лим|L
lepenac|лепенац|L
lab|лаб|L
lugomir|лугомир|L
lepenica|лепеница|L
lužnica|luznica|лужница|K
linovštica|linovstica|линовштица|L
lonja|лоња|L
lika|лика|L
laba|лаба|L
loara|лоара|L
lena|лена|L
limpopo|лимпопо|L
lašva|lasva|лашва|L
ljubiviđa|ljubividja|љубивиђа|LJ
ljig|љиг|L
ljubljanica|љубљаница|LJ
lještanica|ljestanica|љештаница|LJ
ljubostinja|љубостиња|LJ
mlava|млава|M
mostonga|мостонга|M
miruša|mirusa|мируша|LJ
murgovica|мурговица|M
mutnica|мутница|M
marica|марица|M
morača|moraca|морача|M
mura|мура|M
moriš|moris|мориш|M
majna|мајна|M
morava|морава|M
misisipi|мисисипи|M
misuri|мисури|M
mekong|меконг|M
makenzi|макензи|M
mari|мари|M
madeira|мадеира|M
mamore|маморе|M
meza|меза|M
miljacka|миљацка|M
malipek|малипек|M
moskva|москва|M
moravica|моравица|M
nišava|nisava|нишава|M
nera|нера|N
nadela|надела|N
nerodimka|неродимка|N
neretva|неретва|N
nil|нил|N
niger|нигер|N
narin|нарин|N
nortriver|нортривер|N
nelson|нелсон|N
neris|нерис|N
neva|нева|N
nen|нен|N
njemen|њемен|NJ
odijana|одијана|O
odra|одра|O
ob|об|O
olenjok|олењок|O
olonjok|олоњок|O
ohajo|охајо|O
orinoko|ориноко|O
oranje|орање|O
oljo|ољо|O
obnica|обница|O
oka|ока|O
pek|пек|P
plazović|plazovic|плазовић|N
pčinja|pcinja|пчиња|P
pustareka|пустарека|P
pećkabistrica|peckabistrica|пећкабистрица|P
porečkareka|poreckareka|поречкарека|P
petrovačkareka|petrovackareka|петровачкарека|P
prača|praca|прача|P
piva|пива|P
parana|парана|P
pis|пис|P
purus|пурус|P
pandž|pandz|панџ|P
paragvaj|парагвај|P
pilkomajo|пилкомајо|P
po|по|P
prut|прут|P
pliva|плива|P
pečora|pecora|печора|P
pepeljuša|pepeljusa|пепељуша|P
rasina|расина|P
rzav|рзав|R
radika|радика|R
resava|ресава|R
raška|raska|рашка|R
ralja|раља|R
resavica|ресавица|R
rača|raca|рача|R
radovanskareka|радованскарека|R
ribarskareka|рибарскарека|R
rdžavica|rdzavica|рџавица|R
ribnica|рибница|R
rajna|рајна|R
rona|рона|R
riogrande|риогранде|R
rionegro|рионегро|R
reno|рено|R
reka|река|R
rakitnica|ракитница|R
rabas|рабас|R
rječina|rjecina|рјечина|R
sava|сава|R
sitnica|ситница|S
studenica|студеница|S
sokobanjskamoravica|сокобањскаморавица|S
svrljiškitimok|svrljiskitimok|сврљишкитимок|S
skrapež|skrapez|скрапеж|S
studva|студва|S
sibnica|сибница|S
sana|сана|S
spreča|spreca|спреча|S
savinja|савиња|S
soča|soca|соча|S
severn|северн|S
sena|сена|S
saofransisko|саофрансиско|S
sirdarja|сирдарја|S
saluen|салуен|S
senloren|сенлорен|S
saskačevan|saskacevan|саскачеван|S
severnisalado|севернисаладо|S
soma|сома|S
sutjeska|сутјеска|S
sikiang|сикианг|S
tisa|тиса|T
tamiš|tamis|тамиш|S
timok|тимок|T
toplica|топлица|T
tamnava|тамнава|T
temštica|temstica|темштица|T
trgoviškitimok|trgoviskitimok|трговишкитимок|T
toponičkareka|toponickareka|топоничкарека|T
topčiderskareka|topciderskareka|топчидерскарека|T
trebišnjica|trebisnjica|требишњица|T
tara|тара|T
treska|треска|T
temza|темза|T
taho|тахо|T
težo|tezo|тежо|T
tokantins|токантинс|T
tibar|тибар|T
tigar|тигар|T
tarim|тарим|T
tanaro|танаро|T
tigris|тигрис|T
ćehotina|cehotina|ћехотина|T
uvac|увац|Ć
ub|уб|U
una|уна|U
usora|усора|U
ukrina|укрина|U
ural|урал|U
ukajali|укајали|U
ubangi|убанги|U
uele|уеле|U
ugar|угар|U
unac|унац|U
fulda|фулда|F
finli|финли|F
fojnica|фојница|F
foča|foca|фоча|U
hoangho|хоангхо|F
huanghe|хуангхе|H
huanghu|хуангху|H
hadson|хадсон|H
hron|хрон|H
han|хан|H
crnitimok|црнитимок|C
crnica|црница|C
cijevna|цијевна|C
crnidrim|црнидрим|C
crvenareka|црвенарека|C
crvena|црвена|C
cetina|цетина|C
čik|cik|чик|H
čiker|ciker|чикер|Č
čemernica|cemernica|чемерница|Č
čikas|cikas|чикас|Č
čambeši|cambesi|чамбеши|Č
čambezi|cambezi|чамбези|Č
čangđang|cangdjang|чангђанг|Č
čabranka|cabranka|чабранка|Č
čikola|cikola|чикола|Č
džeferson|dzeferson|џеферсон|DŽ
džuba|dzuba|џуба|DŽ
šelovrnac|selovrnac|шеловрнац|Š
šumanka|sumanka|шуманка|Š
štira|stira|штира|Š
šatelarab|satelarab|шателараб|Š
šingu|singu|шингу|Š
šelda|selda|шелда|Š
ščara|scara|шчара|Š
špreja|шпреја|Č
šujica|шујица|Š
spreja|спреја|Š
sujica|сујица|Š
šari|sari|шари|Š
šenon|senon|шенон|Š
šaškareka|шашкарека|Š
šaška|шашка|Š
saskareka|саскарека|Š
