avakum|авакум|
avram|аврам|A
agaton|агатон|A
adam|адам|A
aksentije|аксентије|A
aksa|акса|A
asko|аско|A
aleksa|алекса|A
aleksandar|александар|A
aleksije|алексије|A
aleksej|алексеј|A
alimpije|алимпије|A
andrej|андреј|A
andreja|андреја|A
andrija|андрија|A
andrijaš|andrijas|андријаш|A
andra|андра|A
andro|андро|A
anđelko|andjelko|анђелко|A
antonije|антоније|A
aranđel|arandjel|аранђел|A
arsenije|арсеније|A
arsen|арсен|A
arsa|арса|A
arso|арсо|A
atanasije|атанасије|A
atanacko|атанацко|A
aćim|acim|аћим|A
agnija|агнија|A
agnica|агница|A
adelina|аделина|A
aleksandra|александра|A
aleksija|алексија|A
ana|ана|A
anastasija|анастасија|A
anda|анда|A
andrea|андреа|A
andrijana|андријана|A
anđa|andja|анђа|A
anđela|andjela|анђела|A
anđelka|andjelka|анђелка|A
anđelika|andjelika|анђелика|A
anđelija|andjelija|анђелија|A
angelina|ангелина|A
anka|анка|A
ankica|анкица|A
antonina|антонина|A
antonija|антонија|A
anabela|анабела|A
bajko|бајко|B
bajo|бајо|B
bajčeta|bajceta|бајчета|A
balša|balsa|балша|B
bane|бане|B
batrić|batric|батрић|B
berislav|берислав|B
berisav|берисав|B
beriša|berisa|бериша|B
berko|берко|B
biljan|биљан|B
biserko|бисерко|B
blagoje|благоје|B
blagoja|благоја|B
blagota|благота|B
blagomir|благомир|B
blaža|blaza|блажа|B
blažo|blazo|блажо|B
blažen|blazen|блажен|B
blaško|blasko|блашко|B
boban|бобан|B
bogdan|богдан|B
bogelj|богељ|B
bogić|bogic|богић|B
bogiša|bogisa|богиша|B
bogoboj|богобој|B
bogoje|богоје|B
bogoljub|богољуб|B
bogomir|богомир|B
bogoslav|богослав|B
bogosav|богосав|B
božidar|bozidar|божидар|B
boža|boza|божа|B
božo|bozo|божо|B
božin|bozin|божин|B
božina|bozina|божина|B
božićko|bozicko|божићко|B
boin|боин|B
boica|боица|B
bojan|бојан|B
bojko|бојко|B
bojo|бојо|B
bojčeta|bojceta|бојчета|B
bora|бора|B
boro|боро|B
boran|боран|B
borivoje|боривоје|B
borivoj|боривој|B
boris|борис|B
borislav|борислав|B
borisav|борисав|B
borko|борко|B
boriša|borisa|бориша|B
boroje|бороје|B
boško|bosko|бошко|B
brajan|брајан|B
brajica|брајица|B
branivoje|бранивоје|B
branivoj|бранивој|B
branimir|бранимир|B
branislav|бранислав|B
branko|бранко|B
brano|брано|B
bratimir|братимир|B
bratislav|братислав|B
bratovan|братован|B
bratoljub|братољуб|B
brnča|brnca|брнча|B
budimir|будимир|B
budislav|будислав|B
budisav|будисав|B
biljana|биљана|B
bisenija|бисенија|B
biserka|бисерка|B
blaginja|благиња|B
blagica|благица|B
blaženka|blazenka|блаженка|B
bobana|бобана|B
bogdana|богдана|B
bogdanka|богданка|B
božana|bozana|божана|B
božidarka|bozidarka|божидарка|B
božinka|bozinka|божинка|B
božica|bozica|божица|B
bojana|бојана|B
bojka|бојка|B
boja|боја|B
borika|борика|B
borica|борица|B
borislava|борислава|B
borislavka|бориславка|B
borjana|борјана|B
borjanka|борјанка|B
borka|борка|B
bosa|боса|B
bosiljka|босиљка|B
branislava|бранислава|B
branislavka|браниславка|B
branka|бранка|B
brankica|бранкица|B
bratislava|братислава|B
budimirka|будимирка|B
budimka|будимка|B
vanja|вања|V
vartolomej|вартоломеј|V
vasilije|василије|V
vajo|вајо|V
vasilj|васиљ|V
vasiljko|васиљко|V
vasko|васко|V
vasoje|васоје|V
vasa|васа|V
vaso|васо|V
vaskrsije|васкрсије|V
vatolj|ватољ|V
vekoslav|векослав|V
vjekoslav|вјекослав|V
velibor|велибор|V
velizar|велизар|V
velimir|велимир|V
velemir|велемир|V
velisav|велисав|V
veličko|velicko|величко|B
veliša|velisa|велиша|V
veljko|вељко|V
veran|веран|V
veroljub|верољуб|V
veselin|веселин|V
vesko|веско|V
veso|весо|V
veselko|веселко|V
vidoje|видоје|V
vidak|видак|V
vid|вид|V
vidač|vidac|видач|V
vidan|видан|V
viden|виден|V
vidosav|видосав|V
vidojko|видојко|V
vidoja|видоја|V
viktor|виктор|V
vilotije|вилотије|V
vitomir|витомир|V
vitko|витко|V
vićentije|vicentije|вићентије|V
vićan|vican|вићан|V
višeslav|viseslav|вишеслав|V
vladan|владан|V
vlada|влада|V
vlade|владе|V
vlado|владо|V
vlatko|влатко|V
vladeta|владета|V
vladica|владица|V
vladoje|владоје|V
vladun|владун|V
vladimir|владимир|V
vladislav|владислав|V
vladisav|владисав|V
vlaisav|влаисав|V
vlasije|власије|V
vlajko|влајко|V
vlastimir|властимир|V
vlaško|vlasko|влашко|V
vojdrag|војдраг|V
vojimir|војимир|V
vojkan|војкан|V
vojin|војин|V
vojko|војко|V
voica|воица|V
vojislav|војислав|V
vraneš|vranes|вранеш|V
vugdrag|вугдраг|V
vuzman|вузман|V
vuilo|вуило|V
vuin|вуин|V
vuica|вуица|V
vujadin|вујадин|V
vujak|вујак|V
vujan|вујан|V
vujeta|вујета|V
vujko|вујко|V
vujčeta|vujceta|вујчета|V
vujčin|vujcin|вујчин|V
vujo|вујо|V
vujoš|vujos|вујош|V
vuk|вук|V
vuko|вуко|V
vukalj|вукаљ|V
vukas|вукас|V
vukac|вукац|V
vukač|вукач|V
vukelja|вукеља|V
vukić|vukic|вукић|V
vukša|vuksa|вукша|V
vukadin|вукадин|V
vukan|вукан|V
vukota|вукота|V
vukajlo|вукајло|V
vukalo|вукало|V
vukman|вукман|V
vukoman|вукоман|V
vukmilj|вукмиљ|V
vukoje|вукоје|V
vukojica|вукојица|V
vukola|вукола|V
vukovje|вуковје|V
vukašin|vukasin|вукашин|V
vukomir|вукомир|V
vukmir|вукмир|V
vukoslav|вукослав|V
vukosav|вукосав|V
vuksan|вуксан|V
vuleta|вулета|V
vule|вуле|V
vunko|вунко|V
vučeta|vuceta|вучета|V
vučina|vucina|вучина|V
vučan|vucan|вучан|V
vučen|vucen|вучен|V
vučić|vucic|вучић|V
vučko|vucko|вучко|V
vučur|vucur|вучур|V
vuča|vuca|вуча|V
valerija|валерија|V
varvara|варвара|V
vasilija|василија|V
vasiljka|васиљка|V
vasilka|василка|V
vaskrsija|васкрсија|V
veliborka|велиборка|V
velimirka|велимирка|V
velinka|велинка|V
velisava|велисава|V
vera|вера|V
verka|верка|V
verica|верица|V
veronika|вероника|V
veroslava|верослава|V
veselinka|веселинка|V
vesela|весела|V
veselka|веселка|V
vesna|весна|V
vida|вида|V
vidojka|видојка|V
vidosava|видосава|V
viktorija|викторија|V
violeta|виолета|V
vitka|витка|V
vitomirka|витомирка|V
višeslava|viseslava|вишеслава|V
višnja|visnja|вишња|V
vladana|владана|V
vladanka|владанка|V
vladimirka|владимирка|V
vladislava|владислава|V
vladislavka|владиславка|V
vlajka|влајка|V
vlasta|власта|V
vlastimirka|властимирка|V
vlatka|влатка|V
vojislava|војислава|V
vojislavka|војиславка|V
vojka|војка|V
vujadinka|вујадинка|V
vujka|вујка|V
vujana|вујана|V
vukadinka|вукадинка|V
vukana|вукана|V
vukica|вукица|V
vukosava|вукосава|V
vukmira|вукмира|V
gavrilo|гаврило|G
gaja|гаја|G
gajo|гајо|G
gača|gaca|гача|V
gavra|гавра|G
gavro|гавро|G
gajin|гајин|G
gvozden|гвозден|G
gvozdenko|гвозденко|G
genadije|генадије|G
georgije|георгије|G
gerasim|герасим|G
german|герман|G
gligorije|глигорије|G
gliša|glisa|глиша|G
glišo|gliso|глишо|G
grigorije|григорије|G
godeč|godec|годеч|G
godomir|годомир|G
gojko|гојко|G
golub|голуб|G
goran|горан|G
gordan|гордан|G
gorčin|gorcin|горчин|G
gorčilo|gorcilo|горчило|G
gostimir|гостимир|G
gostoljub|гостољуб|G
gradimir|градимир|G
gradeta|градета|G
gradiša|gradisa|градиша|G
grgur|гргур|G
grdan|грдан|G
grijak|гријак|G
grozdan|гроздан|G
grubeta|грубета|G
grubiša|grubisa|грубиша|G
gruban|грубан|G
grubac|грубац|G
grubeša|grubesa|грубеша|G
gruja|груја|G
grujica|грујица|G
grujo|грујо|G
gavrila|гаврила|G
gavrilka|гаврилка|G
gvozdenija|гвозденија|G
gvozdenka|гвозденка|G
georgina|георгина|G
gorana|горана|G
gorica|горица|G
goranka|горанка|G
gorjana|горјана|G
gordana|гордана|G
gospava|госпава|G
grozdana|гроздана|G
grozda|грозда|G
dabiša|dabisa|дабиша|G
dabo|дабо|D
dabiživ|dabiziv|дабижив|D
david|давид|D
davor|давор|D
dalibor|далибор|D
damir|дамир|D
damjan|дамјан|D
damljan|дамљан|D
danijel|данијел|D
daniel|даниел|D
danilo|данило|D
dane|дане|D
danko|данко|D
dančul|dancul|данчул|D
darije|дарије|D
dario|дарио|D
darijo|даријо|D
darjan|дарјан|D
darko|дарко|D
dejan|дејан|D
desimir|десимир|D
despot|деспот|D
dimitrije|димитрије|D
dimčo|dimco|димчо|D
dmitar|дмитар|D
dobrašin|dobrasin|добрашин|D
dobrilo|добрило|D
dobrica|добрица|D
dobrinko|добринко|D
dobrivoje|добривоје|D
dobrivoj|добривој|D
dobrovuk|добровук|D
dobroslav|доброслав|D
dobrosav|добросав|D
dojčin|dojcin|дојчин|D
dojčilo|dojcilo|дојчило|D
doko|доко|D
dorotej|доротеј|D
dositej|доситеј|D
dragan|драган|D
dragiša|dragisa|драгиша|D
dragić|dragic|драгић|D
dragoja|драгоја|D
dragoje|драгоје|D
dragaš|dragas|драгаш|D
dragojlo|драгојло|D
dragoš|dragos|драгош|D
dragobrat|драгобрат|D
dragosije|драгосије|D
drago|драго|D
dragovan|драгован|D
dragoljub|драгољуб|D
dragoman|драгоман|D
dragomir|драгомир|D
dragorad|драгорад|D
dragoslav|драгослав|D
dragosav|драгосав|D
dragutin|драгутин|D
draža|draza|дража|D
dražo|drazo|дражо|D
dražeta|drazeta|дражета|D
drailo|драило|D
drakša|draksa|дракша|D
draško|drasko|драшко|D
dubravac|дубравац|D
dubravko|дубравко|D
dujak|дујак|D
duka|дука|D
dukadin|дукадин|D
dušan|dusan|душан|D
duško|dusko|душко|D
davorka|даворка|D
daliborka|далиборка|D
damjanka|дамјанка|D
damljanka|дамљанка|D
danijela|данијела|D
danica|даница|D
danka|данка|D
dana|дана|D
danojla|данојла|D
darinka|даринка|D
dara|дара|D
darka|дарка|D
dafina|дафина|D
daša|dasa|даша|D
deva|дева|D
dejana|дејана|D
desanka|десанка|D
desa|деса|D
desimirka|десимирка|D
despina|деспина|D
despinja|деспиња|D
divna|дивна|D
dikosava|дикосава|D
dmitra|дмитра|D
dobrila|добрила|D
dobrina|добрина|D
dobrinka|добринка|D
dobrija|добрија|D
dobroslava|доброслава|D
dobrosava|добросава|D
dobrosavka|добросавка|D
dokna|докна|D
doroteja|доротеја|D
dora|дора|D
dostana|достана|D
dragica|драгица|D
dragana|драгана|D
draga|драга|D
draginja|драгиња|D
dragojla|драгојла|D
dragija|драгија|D
dragomira|драгомира|D
dragomirka|драгомирка|D
dragoslava|драгослава|D
dragoslavka|драгославка|D
drenka|дренка|D
drena|дрена|D
drina|дрина|D
drinka|дринка|D
dubravka|дубравка|D
dunja|дуња|D
dušanka|dusanka|душанка|D
dušica|dusica|душица|D
duška|duska|душка|D
duda|дуда|D
đenadije|djenadije|ђенадије|D
đora|djora|ђора|Đ
đorđe|djordje|ђорђе|Đ
đorđo|djordjo|ђорђо|Đ
đura|djura|ђура|Đ
đuran|djuran|ђуран|Đ
đukan|djukan|ђукан|Đ
đurađ|djuradj|ђурађ|Đ
đuro|djuro|ђуро|Đ
đoka|djoka|ђока|Đ
đoko|djoko|ђоко|Đ
đorđije|djordjije|ђорђије|Đ
đuraš|djuras|ђураш|Đ
đurašin|djurasin|ђурашин|Đ
đuraško|djurasko|ђурашко|Đ
đurisav|djurisav|ђурисав|Đ
đurica|djurica|ђурица|Đ
đurko|djurko|ђурко|Đ
đurđe|djurdje|ђурђе|Đ
đurđa|djurdja|ђурђа|Đ
đurđica|djurdjica|ђурђица|Đ
đurđija|djurdjija|ђурђија|Đ
đurisava|djurisava|ђурисава|Đ
đina|djina|ђина|Đ
đurđina|djurdjina|ђурђина|Đ
đurđevka|djurdjevka|ђурђевка|Đ
đuka|djuka|ђука|Đ
evgenije|евгеније|Đ
emilijan|емилијан|E
emilije|емилије|E
emil|емил|E
erak|ерак|E
eva|ева|E
evica|евица|E
evgenija|евгенија|E
evdokija|евдокија|E
ekaterina|екатерина|E
elena|елена|E
emilija|емилија|E
emina|емина|E
ema|ема|E
žarko|zarko|жарко|E
želimir|zelimir|желимир|Ž
željko|zeljko|жељко|Ž
živa|ziva|жива|Ž
živica|zivica|живица|Ž
živadin|zivadin|живадин|Ž
živan|zivan|живан|Ž
živanko|zivanko|живанко|Ž
živko|zivko|живко|Ž
živojin|zivojin|живојин|Ž
živoin|zivoin|живоин|Ž
živoljub|zivoljub|живољуб|Ž
živomir|zivomir|живомир|Ž
živorad|zivorad|живорад|Ž
živoslav|zivoslav|живослав|Ž
života|zivota|живота|Ž
žika|zika|жика|Ž
žikica|zikica|жикица|Ž
žitomir|zitomir|житомир|Ž
žaklina|zaklina|жаклина|Ž
žanka|zanka|жанка|Ž
želimirka|zelimirka|желимирка|Ž
željka|zeljka|жељка|Ž
željana|zeljana|жељана|Ž
živadinka|zivadinka|живадинка|Ž
živka|zivka|живка|Ž
živoradka|zivoradka|живорадка|Ž
živoratka|zivoratka|живоратка|Ž
živoslava|zivoslava|живослава|Ž
živoslavka|zivoslavka|живославка|Ž
živojinka|zivojinka|живојинка|Ž
zavida|завида|Ž
zaviša|zavisa|завиша|Z
zarija|зарија|Z
zarije|зарије|Z
zaharije|захарије|Z
zafir|зафир|Z
zvezdan|звездан|Z
zvjezdan|звјездан|Z
zvezdodrag|звездодраг|Z
zvezdoslav|звездослав|Z
zvonimir|звонимир|Z
zvonko|звонко|Z
zdravko|здравко|Z
zdraviša|zdravisa|здравиша|Z
zlatan|златан|Z
zlatko|златко|Z
zlatoje|златоје|Z
zlatibor|златибор|Z
zlatomir|златомир|Z
zlatoslav|златослав|Z
zoran|зоран|Z
zrinko|зринко|Z
zagorka|загорка|Z
zaga|зага|Z
zvezdana|звездана|Z
zvjezdana|звјездана|Z
zvonka|звонка|Z
zdravka|здравка|Z
zlata|злата|Z
zlatica|златица|Z
zlatka|златка|Z
zlatana|златана|Z
zlatija|златија|Z
zlatiborka|златиборка|Z
zlatomirka|златомирка|Z
zora|зора|Z
zorica|зорица|Z
zorana|зорана|Z
zorka|зорка|Z
zorislava|зорислава|Z
zrinka|зринка|Z
ivan|иван|I
ivica|ивица|I
ivo|иво|I
ivko|ивко|I
ivaniš|ivanis|иваниш|Z
ignjat|игњат|I
ignjatije|игњатије|I
igor|игор|I
ilija|илија|I
isaija|исаија|I
isailo|исаило|I
isak|исак|I
isidor|исидор|I
iva|ива|I
ivana|ивана|I
ivanka|иванка|I
ivka|ивка|I
ivona|ивона|I
ikonija|иконија|I
ilinka|илинка|I
ilina|илина|I
irena|ирена|I
irina|ирина|I
isidora|исидора|I
jablan|јаблан|J
javorko|јаворко|J
jagoš|jagos|јагош|I
jadranko|јадранко|J
jakov|јаков|J
jakša|jaksa|јакша|J
jandrija|јандрија|J
jandre|јандре|J
janićije|janicije|јанићије|J
janko|јанко|J
janča|janca|јанча|J
jaroslav|јарослав|J
jasen|јасен|J
jasenko|јасенко|J
jevrem|јеврем|J
jevtimije|јевтимије|J
jevta|јевта|J
jevto|јевто|J
jevtan|јевтан|J
jezdimir|јездимир|J
jezda|језда|J
jelašin|jelasin|јелашин|J
jelen|јелен|J
jelenko|јеленко|J
jelisije|јелисије|J
jeremija|јеремија|J
jerko|јерко|J
jerotije|јеротије|J
joakim|јоаким|J
jovan|јован|J
jovica|јовица|J
joviša|jovisa|јовиша|J
jova|јова|J
jovo|јово|J
jovko|јовко|J
joko|јоко|J
jokan|јокан|J
joksim|јоксим|J
jordan|јордан|J
josif|јосиф|J
josip|јосип|J
jugoljub|југољуб|J
jugomir|југомир|J
jugoslav|југослав|J
julijan|јулијан|J
junoša|junosa|јуноша|J
juriša|jurisa|јуриша|J
justin|јустин|J
javorka|јаворка|J
jaglika|јаглика|J
jagoda|јагода|J
jagodinka|јагодинка|J
jadranka|јадранка|J
jana|јана|J
janja|јања|J
janovka|јановка|J
jasmina|јасмина|J
jasminka|јасминка|J
jasna|јасна|J
jevdokija|јевдокија|J
jevrosima|јевросима|J
jela|јела|J
jelica|јелица|J
jelka|јелка|J
jeka|јека|J
jelača|jelaca|јелача|J
jelena|јелена|J
jelenka|јеленка|J
jelisava|јелисава|J
jelisaveta|јелисавета|J
jelisavka|јелисавка|J
jefimija|јефимија|J
ješa|jesa|јеша|J
jovana|јована|J
jovanka|јованка|J
jovka|јовка|J
joka|јока|J
jorgovanka|јоргованка|J
jordanka|јорданка|J
julija|јулија|J
julijana|јулијана|J
julka|јулка|J
kažimir|kazimir|кажимир|J
kalin|калин|K
kamenko|каменко|K
kaprijan|капријан|K
kirilo|кирило|K
koviljko|ковиљко|K
kozma|козма|K
kojadin|којадин|K
kojčin|kojcin|којчин|K
kokan|кокан|K
komnen|комнен|K
konstantin|константин|K
kostadin|костадин|K
kosta|коста|K
kornelije|корнелије|K
koča|koca|коча|K
kraguj|крагуј|K
kraisav|краисав|K
krajčin|krajcin|крајчин|K
krasimir|красимир|K
krasoje|красоје|K
krsman|крсман|K
krsto|крсто|K
krsta|крста|K
krstan|крстан|K
krstivoje|крстивоје|K
krstimir|крстимир|K
krstomir|крстомир|K
krunislav|крунислав|K
kuzman|кузман|K
kumodrag|кумодраг|K
kristijan|кристијан|K
kadivka|кадивка|K
kazimira|казимира|K
kalina|калина|K
kalinka|калинка|K
kasija|касија|K
katarina|катарина|K
kata|ката|K
katica|катица|K
klara|клара|K
kovana|кована|K
koviljka|ковиљка|K
kovina|ковина|K
kovinka|ковинка|K
kojadinka|којадинка|K
komnenija|комненија|K
kosana|косана|K
kosara|косара|K
kosovka|косовка|K
kosa|коса|K
kostadinka|костадинка|K
koštana|kostana|коштана|K
kraisava|краисава|K
kristina|кристина|K
krstina|крстина|K
krsmanija|крсманија|K
krstana|крстана|K
krstinja|крстиња|K
krunoslava|крунослава|K
ksenija|ксенија|K
labud|лабуд|L
lazar|лазар|L
laza|лаза|L
lazo|лазо|L
laka|лака|L
lako|лако|L
laketa|лакета|L
lale|лале|L
ležimir|lezimir|лежимир|K
lepoje|лепоје|L
lepomir|лепомир|L
leposlav|лепослав|L
lozan|лозан|L
lola|лола|L
luka|лука|L
lujo|лујо|L
lana|лана|L
lara|лара|L
latinka|латинка|L
lela|лела|L
lena|лена|L
lenka|ленка|L
leonida|леонида|L
leonora|леонора|L
lepa|лепа|L
leposava|лепосава|L
lidija|лидија|L
liza|лиза|L
lilijana|лилијана|L
lila|лила|L
lozana|лозана|L
lozanka|лозанка|L
loza|лоза|L
luna|луна|L
lučija|lucija|лучија|L
luča|luca|луча|L
ljiljan|љиљан|L
ljuban|љубан|LJ
ljubinko|љубинко|LJ
ljubo|љубо|LJ
ljubiša|ljubisa|љубиша|LJ
ljubivoje|љубивоје|LJ
ljuboje|љубоје|LJ
ljuboja|љубоја|LJ
ljuben|љубен|LJ
ljubenko|љубенко|LJ
ljubislav|љубислав|LJ
ljubisav|љубисав|LJ
ljubobrat|љубобрат|LJ
ljubodrag|љубодраг|LJ
ljubomir|љубомир|LJ
ljepava|љепава|LJ
ljeposava|љепосава|LJ
ljiljana|љиљана|LJ
ljilja|љиља|LJ
ljubica|љубица|LJ
ljuba|љуба|LJ
ljubina|љубина|LJ
ljubinka|љубинка|LJ
ljubomirka|љубомирка|LJ
ljubosava|љубосава|LJ
ljupka|љупка|LJ
mavren|маврен|M
maksim|максим|M
maleta|малета|M
maleš|males|малеш|LJ
mališa|malisa|малиша|M
manojlo|манојло|M
mane|мане|M
marinko|маринко|M
marjan|марјан|M
marko|марко|M
martin|мартин|M
matija|матија|M
matijaš|matijas|матијаш|M
mateja|матеја|M
matej|матеј|M
mato|мато|M
mašan|masan|машан|M
maško|masko|машко|M
medak|медак|M
mijak|мијак|M
mijan|мијан|M
mijat|мијат|M
mija|мија|M
mijo|мијо|M
mijobrat|мијобрат|M
mikan|микан|M
mikoš|mikos|микош|M
miladin|миладин|M
milak|милак|M
milan|милан|M
milanko|миланко|M
milat|милат|M
milaš|milas|милаш|M
milašin|milasin|милашин|M
mile|миле|M
milo|мило|M
milko|милко|M
milen|милен|M
milenko|миленко|M
milentije|милентије|M
mileta|милета|M
mileš|miles|милеш|M
milivoje|миливоје|M
milivoj|миливој|M
milija|милија|M
milijan|милијан|M
milijaš|milijas|милијаш|M
milika|милика|M
milin|милин|M
milinko|милинко|M
milić|milic|милић|M
miličko|milicko|миличко|M
miliša|milisa|милиша|M
milovan|милован|M
miloje|милоје|M
milojko|милојко|M
miloja|милоја|M
milojica|милојица|M
miloljub|милољуб|M
milomir|миломир|M
milonja|милоња|M
milorad|милорад|M
miloslav|милослав|M
milosav|милосав|M
milisav|милисав|M
miloš|milos|милош|M
milten|милтен|M
milun|милун|M
milutin|милутин|M
miluš|milus|милуш|M
miljan|миљан|M
miljen|миљен|M
miljko|миљко|M
milj|миљ|M
miljkan|миљкан|M
miljojko|миљојко|M
miljurko|миљурко|M
miodrag|миодраг|M
mioljub|миољуб|M
miomir|миомир|M
miraš|miras|мираш|M
miren|мирен|M
mirko|мирко|M
miro|миро|M
miroje|мироје|M
miroljub|мирољуб|M
miroslav|мирослав|M
mirosav|миросав|M
mirča|mirca|мирча|M
mirčeta|mirceta|мирчета|M
mitar|митар|M
mita|мита|M
mićan|mican|мићан|M
mićko|micko|мићко|M
mića|mica|мића|M
mićo|mico|мићо|M
mihailo|михаило|M
mihajlo|михајло|M
mijailo|мијаило|M
mijuško|mijusko|мијушко|M
miško|misko|мишко|M
miša|misa|миша|M
mišo|miso|мишо|M
mišljen|misljen|мишљен|M
mladen|младен|M
mlađen|mladjen|млађен|M
mlađan|mladjan|млађан|M
mojsilo|мојсило|M
mojaš|mojas|мојаш|M
momir|момир|M
momčilo|momcilo|момчило|M
mrđan|mrdjan|мрђан|M
mrđen|mrdjen|мрђен|M
mrkša|mrksa|мркша|M
maja|маја|M
majda|мајда|M
makivija|макивија|M
malina|малина|M
malinka|малинка|M
manda|манда|M
manduša|mandusa|мандуша|M
marija|марија|M
mara|мара|M
marica|марица|M
maša|masa|маша|M
marijana|маријана|M
marina|марина|M
marinka|маринка|M
marta|марта|M
mijana|мијана|M
mikosava|микосава|M
mila|мила|M
milana|милана|M
milanka|миланка|M
miladija|миладија|M
miladinka|миладинка|M
mileva|милева|M
milena|милена|M
milka|милка|M
milkica|милкица|M
milijana|милијана|M
milina|милина|M
milinka|милинка|M
milesa|милеса|M
milisava|милисава|M
milisavka|милисавка|M
milosava|милосава|M
milosavka|милосавка|M
milica|милица|M
milojka|милојка|M
milomirka|миломирка|M
milosija|милосија|M
miluka|милука|M
milunka|милунка|M
milunika|милуника|M
miluša|milusa|милуша|M
miljana|миљана|M
miljka|миљка|M
milja|миља|M
mina|мина|M
milna|милна|M
miona|миона|M
miomirka|миомирка|M
mira|мира|M
mirka|мирка|M
mirjana|мирјана|M
miroslava|мирослава|M
mirosava|миросава|M
miroslavka|мирославка|M
mitra|митра|M
mladenka|младенка|M
momirka|момирка|M
monika|моника|M
najdan|најдан|N
naum|наум|N
nebojša|nebojsa|небојша|M
neven|невен|N
nevenko|невенко|N
negovan|негован|N
negomir|негомир|N
negoslav|негослав|N
nedeljko|недељко|N
neđeljko|nedjeljko|неђељко|N
neđo|nedjo|неђо|N
nemanja|немања|N
nenad|ненад|N
neško|nesko|нешко|N
nestor|нестор|N
nikašin|nikasin|никашин|N
nikodim|никодим|N
nikodin|никодин|N
nikodije|никодије|N
nikola|никола|N
nikša|niksa|никша|N
niko|нико|N
ninko|нинко|N
nino|нино|N
ninoslav|нинослав|N
nićifor|nicifor|нићифор|N
novak|новак|N
novica|новица|N
noviša|novisa|новиша|N
novko|новко|N
novo|ново|N
nada|нада|N
nadežda|nadezda|надежда|N
nađa|nadja|нађа|N
nadica|надица|N
najda|најда|N
natalija|наталија|N
nataša|natasa|наташа|N
nevena|невена|N
nevenka|невенка|N
negovanka|негованка|N
negomirka|негомирка|N
negoslava|негослава|N
negoslavka|негославка|N
negosava|негосава|N
neda|неда|N
nedeljka|недељка|N
neđeljka|nedjeljka|неђељка|N
nikoleta|николета|N
nikolija|николија|N
nikolina|николина|N
nina|нина|N
nišava|nisava|нишава|N
novka|новка|N
njegovan|његован|NJ
njegomir|његомир|NJ
njegoslav|његослав|NJ
njegoš|njegos|његош|N
njegomirka|његомирка|NJ
njegoslava|његослава|NJ
njegosava|његосава|NJ
obrad|обрад|O
obradin|обрадин|O
obren|обрен|O
obrenko|обренко|O
obreten|обретен|O
ognjen|огњен|O
ognjan|огњан|O
ozren|озрен|O
ozriša|ozrisa|озриша|NJ
oleg|олег|O
oliver|оливер|O
omilj|омиљ|O
omiljen|омиљен|O
ostoja|остоја|O
otaš|otas|оташ|O
obradinka|обрадинка|O
obrenija|обренија|O
ognjana|огњана|O
ognjanka|огњанка|O
ognjena|огњена|O
ognjenka|огњенка|O
ozrenka|озренка|O
olga|олга|O
olja|оља|O
olivera|оливера|O
pavle|павле|P
pavko|павко|P
pavlić|pavlic|павлић|O
pavić|pavic|павић|P
pantelija|пантелија|P
paun|паун|P
pejak|пејак|P
pejo|пејо|P
periša|perisa|периша|P
perun|перун|P
perunko|перунко|P
petak|петак|P
petar|петар|P
pera|пера|P
pero|перо|P
perica|перица|P
perko|перко|P
petko|петко|P
petoje|петоје|P
petoš|petos|петош|P
petrašin|petrasin|петрашин|P
petraš|petras|петраш|P
petronije|петроније|P
plavša|plavsa|плавша|P
poznan|познан|P
pokrajac|покрајац|P
prvoslav|првослав|P
predrag|предраг|P
premil|премил|P
prerad|прерад|P
prebić|prebic|пребић|P
prodan|продан|P
prokopije|прокопије|P
puniša|punisa|пуниша|P
punan|пунан|P
pureš|pures|пуреш|P
purko|пурко|P
puro|пуро|P
pava|пава|P
pavija|павија|P
pavlija|павлија|P
pauna|пауна|P
pelagija|пелагија|P
persa|перса|P
persida|персида|P
petra|петра|P
petrija|петрија|P
perka|перка|P
poznana|познана|P
prvoslava|првослава|P
prvoslavka|првославка|P
prodana|продана|P
radak|радак|R
radan|радан|R
radas|радас|R
radašin|radasin|радашин|P
rade|раде|R
raden|раден|R
radenko|раденко|R
radeta|радета|R
radivoje|радивоје|R
radivoj|радивој|R
radin|радин|R
radinko|радинко|R
radič|radic|радич|R
radiša|radisa|радиша|R
radman|радман|R
radoman|радоман|R
radmilo|радмило|R
radoba|радоба|R
radobud|радобуд|R
radovan|радован|R
radovac|радовац|R
radovin|радовин|R
radoje|радоје|R
radojko|радојко|R
radojlo|радојло|R
radoja|радоја|R
radojica|радојица|R
radomir|радомир|R
radonja|радоња|R
radoslav|радослав|R
radosav|радосав|R
radislav|радислав|R
radisav|радисав|R
radota|радота|R
radoš|rados|радош|R
radukan|радукан|R
radul|радул|R
radule|радуле|R
radulin|радулин|R
radun|радун|R
radusin|радусин|R
rađen|radjen|рађен|R
rain|раин|R
raica|раица|R
raič|raic|раич|R
raičko|raicko|раичко|R
rajak|рајак|R
rajan|рајан|R
rajko|рајко|R
rajčeta|rajceta|рајчета|R
ralen|рален|R
raleta|ралета|R
ranisav|ранисав|R
ranko|ранко|R
raosav|раосав|R
rastislav|растислав|R
rastko|растко|R
ratibor|ратибор|R
ratko|ратко|R
ratomir|ратомир|R
rafailo|рафаило|R
racko|рацко|R
račeta|raceta|рачета|R
raško|rasko|рашко|R
rekula|рекула|R
relja|реља|R
resan|ресан|R
ristan|ристан|R
risto|ристо|R
rista|риста|R
ristivoje|ристивоје|R
rodoljub|родољуб|R
rusmir|русмир|R
rada|рада|R
radica|радица|R
radana|радана|R
radanka|раданка|R
radena|радена|R
radenka|раденка|R
radina|радина|R
radinka|радинка|R
radmila|радмила|R
radna|радна|R
radovanka|радованка|R
radovinka|радовинка|R
radojka|радојка|R
radojla|радојла|R
radomira|радомира|R
radomirka|радомирка|R
radoslava|радослава|R
radoslavka|радославка|R
radislava|радислава|R
radislavka|радиславка|R
raduka|радука|R
radula|радула|R
radulka|радулка|R
radunka|радунка|R
raduša|radusa|радуша|R
rajka|рајка|R
rajna|рајна|R
ranka|ранка|R
ratka|ратка|R
roksanda|роксанда|R
rosa|роса|R
ruža|ruza|ружа|R
ružica|ruzica|ружица|R
rusmira|русмира|R
sava|сава|S
savo|саво|S
savan|саван|S
savko|савко|S
samuilo|самуило|S
saša|sasa|саша|R
svetibor|светибор|S
svetislav|светислав|S
svetko|светко|S
svetozar|светозар|S
svetolik|светолик|S
svetoljub|светољуб|S
svetomir|светомир|S
svetorad|светорад|S
sekula|секула|S
selak|селак|S
selimir|селимир|S
sibin|сибин|S
simeon|симеон|S
simeun|симеун|S
sima|сима|S
simo|симо|S
simon|симон|S
sinđel|sindjel|синђел|S
siniša|sinisa|синиша|S
skorosav|скоросав|S
slaven|славен|S
slavenko|славенко|S
slavko|славко|S
slaviša|slavisa|славиша|S
slavo|славо|S
slavoljub|славољуб|S
slavomir|славомир|S
slavuj|славуј|S
sladoje|сладоје|S
slađan|sladjan|слађан|S
slobodan|слободан|S
smiljan|смиљан|S
smiljko|смиљко|S
smoljan|смољан|S
sokol|сокол|S
soko|соко|S
solomon|соломон|S
spasoje|спасоје|S
spasoja|спасоја|S
spiridon|спиридон|S
spira|спира|S
spomenko|споменко|S
srbislav|србислав|S
srboslav|србослав|S
srboljub|србољуб|S
srdan|срдан|S
srđan|srdjan|срђан|S
srđa|srdja|срђа|S
sergije|сергије|S
sergej|сергеј|S
sredoje|средоје|S
sredoja|средоја|S
sreten|сретен|S
sretko|сретко|S
srećko|srecko|срећко|S
srećan|srecan|срећан|S
stajko|стајко|S
staja|стаја|S
stajo|стајо|S
stamen|стамен|S
stamenko|стаменко|S
stanimir|станимир|S
stanislav|станислав|S
stanisav|станисав|S
staniša|stanisa|станиша|S
stanko|станко|S
stanoje|станоје|S
stanojko|станојко|S
stanojlo|станојло|S
stanoja|станоја|S
stefan|стефан|S
stevan|стеван|S
stevo|стево|S
steva|стева|S
stevica|стевица|S
stepan|степан|S
stjepan|стјепан|S
stoin|стоин|S
stoić|stoic|стоић|S
stojadin|стојадин|S
stojak|стојак|S
stojan|стојан|S
stojko|стојко|S
stojmen|стојмен|S
stojša|stojsa|стојша|S
strahinja|страхиња|S
strainja|страиња|S
savica|савица|S
savka|савка|S
sazdana|саздана|S
sandra|сандра|S
sanela|санела|S
sanja|сања|S
sara|сара|S
svetislava|светислава|S
svetlana|светлана|S
svjetlana|свјетлана|S
sekana|секана|S
sibina|сибина|S
sibinka|сибинка|S
simana|симана|S
simeuna|симеуна|S
simka|симка|S
simonida|симонида|S
simona|симона|S
sinđa|sindja|синђа|S
skorosava|скоросава|S
slavica|славица|S
slavka|славка|S
slavna|славна|S
slavojka|славојка|S
slađana|sladjana|слађана|S
slađa|sladja|слађа|S
slobodanka|слободанка|S
smiljana|смиљана|S
smiljka|смиљка|S
smilja|смиља|S
smoljana|смољана|S
smoljka|смољка|S
snežana|snezana|снежана|S
snježana|snjezana|сњежана|S
sofija|софија|S
sovija|совија|S
soka|сока|S
sonja|соња|S
solumija|солумија|S
spasenija|спасенија|S
spomenka|споменка|S
srbijanka|србијанка|S
sretenka|сретенка|S
stajka|стајка|S
staka|стака|S
stamena|стамена|S
stamenka|стаменка|S
stana|стана|S
stanka|станка|S
stanija|станија|S
stanica|станица|S
stanika|станика|S
stanava|станава|S
stanača|stanaca|станача|S
stanimirka|станимирка|S
stanislava|станислава|S
stanislavka|станиславка|S
stanisava|станисава|S
stanojka|станојка|S
stanojla|станојла|S
staša|stasa|сташа|S
stevanija|стеванија|S
stefana|стефана|S
stoisava|стоисава|S
stojadinka|стојадинка|S
stojana|стојана|S
stojanka|стојанка|S
stojka|стојка|S
stoja|стоја|S
stojna|стојна|S
suzana|сузана|S
sunčica|suncica|сунчица|S
tadej|тадеј|S
tadija|тадија|T
tanasije|танасије|T
tanasko|танаско|T
tanacko|танацко|T
tatomir|татомир|T
tvrtko|твртко|T
teodor|теодор|T
todor|тодор|T
tiodor|тиодор|T
teodosije|теодосије|T
teofil|теофил|T
tešan|tesan|тешан|T
timotej|тимотеј|T
timotije|тимотије|T
tihomir|тихомир|T
toma|тома|T
tomo|томо|T
tomaš|tomas|томаш|T
tomica|томица|T
tomislav|томислав|T
toplica|топлица|T
trajan|трајан|T
trajko|трајко|T
trifun|трифун|T
trivun|тривун|T
tripun|трипун|T
trifko|трифко|T
trivko|тривко|T
tripko|трипко|T
trojan|тројан|T
trpko|трпко|T
tajana|тајана|T
tamara|тамара|T
tankosa|танкоса|T
tankosava|танкосава|T
tara|тара|T
tatjana|татјана|T
tanja|тања|T
teodora|теодора|T
todora|тодора|T
tea|теа|T
teona|теона|T
tijana|тијана|T
tihomirka|тихомирка|T
tomanija|томанија|T
tomana|томана|T
tomka|томка|T
ćirilo|cirilo|ћирило|T
ćirko|cirko|ћирко|Ć
ćira|cira|ћира|Ć
ćiro|ciro|ћиро|Ć
ćirjak|cirjak|ћирјак|Ć
ćerana|cerana|ћерана|Ć
uglješa|ugljesa|угљеша|U
umiljen|умиљен|Ć
uroš|uros|урош|U
utješen|utjesen|утјешен|U
utešen|utesen|утешен|U
ubavka|убавка|U
una|уна|U
filimon|филимон|F
filip|филип|F
fema|фема|F
femka|фемка|F
hvalimir|хвалимир|H
hvalislav|хвалислав|H
hranimir|хранимир|H
hranislav|хранислав|H
hraniša|hranisa|храниша|U
hrastimir|храстимир|H
hristijan|христијан|H
hristoslav|христослав|H
hristof|христоф|H
hranislava|хранислава|H
hristina|христина|H
cvejan|цвејан|C
cvijan|цвијан|C
cveja|цвеја|C
cvijo|цвијо|C
cvetan|цветан|C
cvetin|цветин|C
cvijetin|цвијетин|C
cvetko|цветко|C
cvjetko|цвјетко|C
cvetoje|цветоје|C
cvjetoje|цвјетоје|C
cvetoš|cvetos|цветош|H
cvijetoš|cvijetos|цвијетош|C
cviko|цвико|C
curko|цурко|C
cveta|цвета|C
cvijeta|цвијета|C
cvetana|цветана|C
cvetanka|цветанка|C
cvija|цвија|C
cmiljana|цмиљана|C
cmilja|цмиља|C
cmiljka|цмиљка|C
časlav|caslav|часлав|C
čedomir|cedomir|чедомир|Č
čeda|ceda|чеда|Č
čedo|cedo|чедо|Č
čubrilo|cubrilo|чубрило|Č
čarna|carna|чарна|Č
časlavka|caslavka|чаславка|Č
čedomirka|cedomirka|чедомирка|Č
šakota|sakota|шакота|Š
šale|sale|шале|Š
špiro|spiro|шпиро|Š
šćepan|scepan|шћепан|Š
šumenko|sumenko|шуменко|Š
šutan|sutan|шутан|Š
šana|sana|шана|Š
