avganistan|авганистан|a
azerbejdžan|azerbejdzan|азербејџан|a
albanija|албанија|a
alžir|alzir|алжир|a
angola|ангола|a
andora|андора|a
antigva i barbuda|антигва и барбуда|a
argentina|аргентина|a
australija|аустралија|a
austrija|аустрија|a
bangladeš|banglades|бангладеш|b
barbados|барбадос|b
bahame|бахаме|b
bahrein|бахреин|b
belgija|белгија|b
belize|белизе|b
belorusija|белорусија|b
benin|бенин|b
bolivija|боливија|b
bosna i hercegovina|босна и херцеговина|b
bocvana|боцвана|b
brazil|бразил|b
brunej|брунеј|b
bugarska|бугарска|b
burkina faso|буркина фасо|b
burundi|бурунди|b
butan|бутан|b
vanuatu|вануату|v
venecuela|венецуела|v
vijetnam|вијетнам|v
gabon|габон|g
gambija|гамбија|g
gana|гана|g
gvajana|гвајана|g
gvatemala|гватемала|g
gvineja|гвинеја|g
gvineja bisao|гвинеја бисао|g
grenada|гренада|g
gruzija|грузија|g
grčka|grcka|грчка|g
danska|данска|d
dominika|доминика|d
dominikanska republika|доминиканска република|d
egipat|египат|e
ekvador|еквадор|e
ekvatorijalna gvineja|екваторијална гвинеја|e
eritreja|еритреја|e
estonija|естонија|e
etiopija|етиопија|e
zambija|замбија|z
zelenortska ostrva|зеленортска острва|z
zimbabve|зимбабве|z
izrael|израел|i
indija|индија|i
indonezija|индонезија|i
irak|ирак|i
iran|иран|i
irska|ирска|i
island|исланд|i
istočni timor|istocni timor|источни тимор|i
italija|италија|i
jamajka|јамајка|j
japan|јапан|j
jemen|јемен|j
jermenija|јерменија|j
jordan|јордан|j
južna koreja|juzna koreja|јужна кореја|j
južni sudan|juzni sudan|јужни судан|j
južnoafrička republika|juznoafricka republika|јужноафричка република|j
kazahstan|казахстан|k
kambodža|kambodza|камбоџа|k
kamerun|камерун|k
kanada|канада|k
katar|катар|k
kenija|кенија|k
kina|кина|k
kipar|кипар|k
kirgistan|киргистан|k
kiribati|кирибати|k
kolumbija|колумбија|k
demokratska republika kongo|демократска република конго|d
republika kongo|република конго|r
komori|комори|k
kostarika|костарика|k
kuba|куба|k
kuvajt|кувајт|k
laos|лаос|l
lesoto|лесото|l
letonija|летонија|l
liban|либан|l
liberija|либерија|l
libija|либија|l
litvanija|литванија|l
lihtenštajn|lihtenstajn|лихтенштајн|l
luksemburg|луксембург|l
madagaskar|мадагаскар|m
mađarska|madjarska|мађарска|m
severna makedonija|северна македонија|s
malavi|малави|m
maldivi|малдиви|m
malezija|малезија|m
mali|мали|m
malta|малта|m
maroko|мароко|m
maršalska ostrva|marsalska ostrva|маршалска острва|m
mauritanija|мауританија|m
mauricijus|маурицијус|m
meksiko|мексико|m
savezne države mikronezije|savezne drzave mikronezije|савезне државе микронезије|s
mjanmar|мјанмар|m
mozambik|мозамбик|m
moldavija|молдавија|m
monako|монако|m
mongolija|монголија|m
namibija|намибија|n
nauru|науру|n
nemačka|nemacka|немачка|n
nepal|непал|n
niger|нигер|n
nigerija|нигерија|n
nikaragva|никарагва|n
novi zeland|нови зеланд|n
norveška|norveska|норвешка|n
obala slonovače|obala slonovace|обала слоноваче|o
oman|оман|o
pakistan|пакистан|p
palau|палау|p
panama|панама|p
papua nova gvineja|папуа нова гвинеја|p
paragvaj|парагвај|p
peru|перу|p
poljska|пољска|p
portugalija|португалија|p
ruanda|руанда|r
rumunija|румунија|r
rusija|русија|r
salvador|салвадор|s
samoa|самоа|s
san marino|сан марино|s
sao tome i prinsipe|сао томе и принсипе|s
saudijska arabija|саудијска арабија|s
esvatini|есватини|e
sveta lucija|света луција|s
sent vinsent i grenadini|сент винсент и гренадини|s
sent kits i nevis|сент китс и невис|s
severna koreja|северна кореја|s
sejšeli|sejseli|сејшели|s
senegal|сенегал|s
sijera leone|сијера леоне|s
singapur|сингапур|s
sirija|сирија|s
sjedinjene američke države|sjedinjene americke drzave|сједињене америчке државе|s
slovačka|slovacka|словачка|s
slovenija|словенија|s
solomonova ostrva|соломонова острва|s
somalija|сомалија|s
srbija|србија|s
sudan|судан|s
surinam|суринам|s
tajland|тајланд|t
tanzanija|танзанија|t
tadžikistan|tadzikistan|таџикистан|t
togo|того|t
tonga|тонга|t
trinidad i tobago|тринидад и тобаго|t
tuvalu|тувалу|t
tunis|тунис|t
turkmenistan|туркменистан|t
turska|турска|t
uganda|уганда|u
uzbekistan|узбекистан|u
ujedinjeni arapski emirati|уједињени арапски емирати|u
ujedinjeno kraljevstvo|уједињено краљевство|u
ukrajina|украјина|u
urugvaj|уругвај|u
filipini|филипини|f
finska|финска|f
fidži|fidzi|фиџи|f
francuska|француска|f
haiti|хаити|h
holandija|холандија|h
honduras|хондурас|h
hrvatska|хрватска|h
centralnoafrička republika|centralnoafricka republika|централноафричка република|c
crna gora|црна гора|c
čad|cad|чад|č
češka|ceska|чешка|č
čile|cile|чиле|č
džibuti|dzibuti|џибути|d
švajcarska|svajcarska|швајцарска|š
švedska|svedska|шведска|š
španija|spanija|шпанија|š
šri lanka|sri lanka|шри ланка|š
vatikan|ватикан|v
palestina|палестина|p
država palestina|drzava palestina|држава палестина|d
abhazija|абхазија|a
azavad|азавад|a
azad kašmir|azad kasmir|азад кашмир|a
zapadna sahara|западна сахара|z
južna osetija|juzna osetija|јужна осетија|j
kukova ostrva|кукова острва|k
republika arcah|република арцах|r
nijue|нијуе|n
pridnjestrovlje|придњестровље|p
republika kina|република кина|r
turska republika severni kipar|турска република северни кипар|t
somalilend|сомалиленд|s
antarktik|антарктик|a
ostrva spretli|острва спретли|o
paracelska ostrva|парацелска острва|p
mikronacija|микронација|m
malteški viteški red|malteski viteski red|малтешки витешки ред|m
kneževina seborga|knezevina seborga|кнежевина себорга|k
silend|силенд|s
kraljevstvo tavolara|краљевство таволара|k
